OOO  O OO OOOOO
 O  OO    OOO  
 O O    OO O  O
   O OO O  OO O
OO      OO OO  
OOO  O        O
 O      O OOO  
 O O O  OO O  O
   O OO O  OO O
OO      OO OO  
OOO  O OO   OOO
 O  OO  O OOO  
 O O       O  O
   O OO O     O
GO   O  OO OO  