OOO  O OO OOOOO
 O  OO  O OOO  
 O O O  OO O  O
   O OO O  OO O
OO   O  OO OO  
OOO  O OO OOOOO
 O  OO  O OOO  
 O O O  OO O  O
   O OO O  OO O
OO   O  OO OO  
OOO  O OO OOOOO
 O  OO  O OOO  
 O O O  OO O  O
   O OO O  OO O
GO   O  OO OO  